profligate - spend resources carelessly
prevaricate - speak in evasive way
calumny - false accusations
belie - giving false representation
acrimony-bitterness and illwill
demur - show strong reluctance
amenable - easily persuaded
superfluous - more than what is needed
impudent - impertinent - gall- improperly forward or bold
vehement - fierce strong emotions
incisive - ability to draw fine distinctions
predilection - strong liking
didactic - instructive
reticent - not revealing ones thoughts
incongruous - lack in harmony
quotidian - observed in ordinary events
tenacious - clingy
spurious - plausible but flase
travesty - mockery
ascetic - practicing self denial
forlorn - hopelesssnes
guileless - lack of deciet
eclectic  - comprising of various styles
apocryphal - of questionable authenticity
ostentatious - showy
unscrupuluous - without principles
burgeon - grow and flourish
acerbic - harsh tone
largess - extreme generosity
exalt - high praise
hackneyed - banal , lacking importance due to overuse
tortuous - marked by repeated turns or bends
petulant - easily irritated
denigrate - flase accusation
implausible - unbelievable
exacting - demanding accuracy
provincial - not fashionable
temperance - trait of avoiding excesses
construe - interpreted in a particular way
intransigent - not willing to change ones beliefs
admonitory - warning
implacable - incapable of making less angry
exonerate - pronounce not guilty
copious - abundant supply
espouse - support an idea
denigrate - false accusation



